13 49
#################################################
#x       P       x                  x          x#
# ############### ################## ########## #
# ############### ################## ########## #
# ##x         x##x      G      x    x          x#
# ############ ## ############# #### ########## #
# ############ ## ############# #### ########## #
#x            x  x   x##x      x    x x##x  x## #
# ############ ###### ## #############x  x##x  x#
# ##x         x###### ## ###################### #
# ## ######### ##x   x##x  x###x   x########### #
#x  x#########x  x###x  x##x   x###x           x#
#################################################
