size: 23 34

spawns: {
    pacman: 5  23
    ghost: 22  23
}

portals: {
   1 2 15 34
}

typemap: {

    # @ # # # # # # # # # # # # # # # # # # # # # # # # # # # # # # # #
    # = # # x _ _ _ _ _ _ _ x _ _ _ x _ _ x _ _ _ _ _ _ _ _ _ _ _ _ x #
    # = # # _ # # # # # # # _ # # # _ # # _ # # # # # # # # # # # # _ #
    # = # # _ # # # # # # # _ # # # _ # # _ # # # # # # # # # # # # _ #
    # = # # x _ _ _ _ _ _ _ x _ _ _ x # # x _ _ x _ _ x _ _ x _ _ _ x #
    # _ # # _ # # # # # # # # # # # _ # # _ # # _ # # _ # # _ # # # # #
    # _ # # _ # # # # # # # # # # # _ # # _ # # _ # # _ # # _ # 0 0 0 0
    # x _ _ x _ _ _ _ _ _ _ x _ _ _ x # # _ # # _ # # _ # # _ # # # # #
    # _ # # # # # # # # # # _ # # # _ # # _ # # _ # # _ # # x _ _ _ x #
    # _ # 0 0 0 # # # # # # _ # # # _ # # _ # # _ # # _ # # # # # # _ #
    # _ # 0 0 0 # x _ _ x _ x _ _ _ x # # _ # # _ # # _ # # # # # # _ #
    # _ # 0 0 0 # _ # # _ # # # # # _ # # _ # # _ # # _ # # x _ _ _ x #
    # _ # 0 0 0 # _ # # _ # 0 0 0 # _ # # x _ _ x _ _ x # # _ # # # # #
    # _ # # # # # _ # # _ # 0 0 0 # _ # # _ # # # # # _ # # _ # # # # #
    # x _ _ _ _ _ x # # _ # # # # # _ # # _ # 0 0 0 # _ # # x = = = = @
    # _ # # # # # _ # # x _ _ _ _ _ x # # _ # 0 0 0 # _ # # _ # # # # #
    # _ # 0 0 0 # _ # # _ # # # # # # # # _ # 0 0 0 # _ # # _ # # # # #
    # _ # # # # # _ # # _ # # # # # # # # _ # # # # # _ # # x _ _ _ x #
    # _ # # x _ _ x # # x _ _ _ _ _ x # # x _ _ x _ _ x # # # # # # _ #
    # _ # # _ # # # # # # # # # # # _ # # _ # # _ # # _ # 0 0 0 0 # _ #
    # _ # # _ # # # # # # # # # # # _ # # _ # # _ # # _ # # # # # # _ #
    # x _ _ x _ _ x # # x _ _ _ _ _ x _ _ x # # x # # x _ _ _ _ _ _ x #
    # # # # # # # # # # # # # # # # # # # # # # # # # # # # # # # # # #

}

options: {



    # _ # + # # # # # # # # # # # # # # # # # # # # # # # # # # # # # +
    # . # # . . . . . . . . . . . . . . . . . . . . . . . . . . . . . #
    # . # # . * # # # # # * . * # * . * * . * # # # # # # # # # # * . #
    # . # # . * # # # # # * . * # * . # # . * # # # # # # # # # # * . #
    # . # # . . . . . . . . . . . . . # # . _ _ _ _ _ . . . . . . . . #
    # . # # . * # # # # # # # # # * . # # . * * . * * . * * . * # # # +
    # . * * . * # # # # # # # # # * . # # . # # . # # . # # . # 0 0 0 0
    # . . . . . . . . . . . . . . . . # # . # # . # # . # # . * # # # +
    # . * # # # # # # # # * . * # * . # # . # # . # # . # # . . . . . #
    # . # 0 0 0 + # # # # * . * # * . # # . # # . # # . # + # # # * . #
    # . # 0 0 0 # . . . . . . . . . . # # . # # . # # . # + # # # * . #
    # . # 0 0 0 # . * * . * # # # * . # # . * * . * * . # # . . . . . #
    # . # 0 0 0 # . # # . # 0 0 0 # . # # . . . . . . . # # . * # # # +
    # . * # # # * . # # . # 0 0 0 # . # # . * # # # * . # # . * # # # #
    # . . . . . . . # # . * # # # * . # # . # 0 0 0 # . # # . . . . . _
    # . * # # # * . # # . . . . . . . # # . # 0 0 0 # . # # . * # # # #
    # . # 0 0 0 # . # # . * # # # # # + # . # 0 0 0 # . # # . * # # # +
    # . # + # # * . # # . * # # # # # + # . * # # # * . # # . . . . . #
    # . # # . . . . # # . . . . . . . # # . . . . . . . # + # # # * . #
    # . # # . * # # + + # # # # # * . # # . * * _ * * . # 0 0 0 0 # . #
    # . * * . * # # + + # # # # # * . * * . # # _ # # . * # # # # * . #
    # . . . . . . . # # . . . . . . . . . . # # _ # # . . . . . . . . #
    + # # # # # # # + + # # # # # # # # # # + + # + + # # # # # # # # +

}

directions: {



    > v < # v v v v v v v v v v v v v v v v v v v v v v v v v v v v v v
    > _ < > _ _ _ _ _ _ _ _ _ _ _ _ _ _ _ _ _ _ _ _ _ _ _ _ _ _ _ _ _ <
    > _ < > _ > ^ ^ ^ ^ ^ v _ > ^ v _ > v _ > ^ ^ ^ ^ ^ ^ ^ ^ ^ ^ v _ <
    > _ < > _ ^ v v v v v < _ ^ v < _ < > _ ^ v v v v v v v v v v < _ <
    > _ < > _ _ _ _ _ _ _ _ _ _ _ _ _ < > _ _ _ _ _ _ _ _ _ _ _ _ _ _ <
    > _ < > _ > ^ ^ ^ ^ ^ ^ ^ ^ ^ v _ < > _ > v _ > v _ > v _ > ^ ^ ^ <
    > _ ^ < _ ^ v v v v v v v v v < _ < > _ < > _ < > _ < > _ < 0 0 0 0
    > _ _ _ _ _ _ _ _ _ _ _ _ _ _ _ _ < > _ < > _ < > _ < > _ ^ v v v v
    > _ > ^ ^ ^ ^ ^ ^ ^ ^ v _ > ^ v _ < > _ < > _ < > _ < > _ _ _ _ _ <
    > _ < 0 0 0 > v v v v < _ ^ v < _ < > _ < > _ < > _ < ^ ^ ^ ^ v _ <
    > _ < 0 0 0 > _ _ _ _ _ _ _ _ _ _ < > _ < > _ < > _ < > v v v < _ <
    > _ < 0 0 0 > _ > v _ > ^ ^ ^ v _ < > _ ^ < _ ^ < _ < > _ _ _ _ _ <
    > _ < 0 0 0 > _ < > _ < 0 0 0 > _ < > _ _ _ _ _ _ _ < > _ > ^ ^ ^ <
    > _ ^ v v v < _ < > _ < 0 0 0 > _ < > _ > ^ ^ ^ v _ < > _ ^ v v v v
    > _ _ _ _ _ _ _ < > _ ^ v v v < _ < > _ < 0 0 0 > _ < > _ _ _ _ _ <
    > _ > ^ ^ ^ v _ < > _ _ _ _ _ _ _ < > _ < 0 0 0 > _ < > _ > ^ ^ ^ ^
    > _ < 0 0 0 > _ < > _ > ^ ^ ^ ^ ^ < > _ < 0 0 0 > _ < > _ ^ v v v v
    > _ < > v v < _ < > _ ^ v v v v v v > _ ^ v v v < _ < > _ _ _ _ _ <
    > _ < > _ _ _ _ < > _ _ _ _ _ _ _ < > _ _ _ _ _ _ _ < ^ ^ ^ ^ v _ <
    > _ < > _ > ^ ^ < ^ ^ ^ ^ ^ ^ v _ < > _ > v _ > v _ < 0 0 0 0 > _ <
    > _ ^ < _ ^ v v v > v v v v v < _ ^ < _ < > _ < > _ ^ v v v v < _ <
    > _ _ _ _ _ _ _ < > _ _ _ _ _ _ _ _ _ _ < > _ < > _ _ _ _ _ _ _ _ <
    ^ ^ ^ ^ ^ ^ ^ ^ < ^ ^ ^ ^ ^ ^ ^ ^ ^ ^ ^ < ^ ^ < ^ ^ ^ ^ ^ ^ ^ ^ ^ <

}

blueprint: {


    # _ # # # # # # # # # # # # # # # # # # # # # # # # # # # # # # # #
    # _ # # _ _ _ _ _ _ _ _ _ _ _ _ _ _ _ _ _ _ _ _ _ _ _ _ _ _ _ _ _ #
    # _ # # _ # # # # # # # _ # # # _ # # _ # # # # # # # # # # # # _ #
    # _ # # _ # # # # # # # _ # # # _ # # _ # # # # # # # # # # # # _ #
    # _ # # _ _ _ _ _ _ _ _ _ _ _ _ _ # # _ _ _ _ _ _ _ _ _ _ _ _ _ _ #
    # _ # # _ # # # # # # # # # # # _ # # _ # # # # # _ # # _ # # # # #
    # _ # # _ # # # # # # # # # # # _ # # _ # # # # # _ # # _ # 0 0 0 0
    # _ _ _ _ _ _ _ _ _ _ _ _ _ _ _ _ # # _ # # _ # # _ # # _ # # # # #
    # _ # # # # # # # # # # _ # # # _ # # _ # # _ # # _ # # _ _ _ _ _ #
    # _ # 0 0 0 # # # # # # _ # # # _ # # _ # # _ # # _ # # # # # # _ #
    # _ # 0 0 0 # _ _ _ _ _ _ _ _ _ _ # # _ # # _ # # _ # # # # # # _ #
    # _ # 0 0 0 # _ # # _ # # # # # _ # # _ # # _ # # _ # # _ _ _ _ _ #
    # _ # 0 0 0 # _ # # _ # 0 0 0 # _ # # _ _ _ _ _ _ _ # # _ # # # # #
    # _ # # # # # _ # # _ # 0 0 0 # _ # # _ # # # # # _ # # _ # # # # #
    # _ _ _ _ _ _ _ # # _ # # # # # _ # # _ # 0 0 0 # _ # # _ _ _ _ _ _
    # _ # # # # # _ # # _ _ _ _ _ _ _ # # _ # 0 0 0 # _ # # _ # # # # #
    # _ # 0 0 0 # _ # # _ # # # # # # # # _ # 0 0 0 # _ # # _ # # # # #
    # _ # # # # # _ # # _ # # # # # # # # _ # # # # # _ # # _ _ _ _ _ #
    # _ # # _ _ _ _ # # _ _ _ _ _ _ _ # # _ _ _ _ _ _ _ # # # # # # _ #
    # _ # # _ # # # # # # # # # # # _ # # _ # # _ # # _ # 0 0 0 0 # _ #
    # _ # # _ # # # # # # # # # # # _ # # _ # # _ # # _ # # # # # # _ #
    # _ _ _ _ _ _ _ # # _ _ _ _ _ _ _ _ _ _ # # _ # # _ _ _ _ _ _ _ _ #
    # # # # # # # # # # # # # # # # # # # # # # # # # # # # # # # # # #


}