size: 5 13

spawns: {
    pacman: 2 4
    ghost:  4 3
}

typemap: {

    # # # # # # # # # # # # #
    # x _ _ _ _ _ _ _ _ _ x #
    # # # # # # # # # # # # #
    # x _ _ _ _ _ _ _ _ _ x #
    # # # # # # # # # # # # #

}

options: {

    # # # # # # # # # # # # #
    # _ . . . . . . . . . _ #
    # # # # # # # # # # # # #
    # _ _ _ _ _ _ _ _ _ _ _ #
    # # # # # # # # # # # # #
}

directions: {

    # # # # # # # # # # # # #
    # _ _ _ _ _ _ _ _ _ _ _ #
    # # # # # # # # # # # # #
    # _ _ _ _ _ _ _ _ _ _ _ #
    # # # # # # # # # # # # #

}

blueprint: {

    # # # # # # # # # # # # #
    # _ _ _ _ _ _ _ _ _ _ _ #
    # # # # # # # # # # # # #
    # _ _ _ _ _ _ _ _ _ _ _ #
    # # # # # # # # # # # # #

}


