17 49
#################################################
#x       P       x BBBBBBBBBBBBBBBB x BBBBBBBB x#
# ############### ################## ########## #
# ############### ################## ########## #
# ##x BBBBBBB x##x BBBBBGBBBBB x BB x BBBBBBBB x#
# ############B##B#############B####B########## #
# ############B##B#############B####B########## #
# ############B##B#############B####B########## #
#x BBBBBBBBBB x  x   x##x BBBB x BB x x##xBBx## #
# ############ ###### ## #############B##B##B## #
# ############ ###### ## #############xBBx##xBBx#
# ##x BBBBBBB x###### ## ###################### #
# ## ######### ###### ## ###################### #
# ## ######### ##xBBBx##xBBx###xBBBx########### #
# ## ######### ##B###B##B##B###B###B########### #
#x  x#########xBBx###xBBx##xBBBx###xBBBBBBBBBBBx#
#################################################
