size: 12 18

spawns: {
    pacman: 5 5
    ghost:  8 14
}

portals: {
    2 1 11 18
}

typemap: {

        # # # # # # # # # # # # # # # # # #
        @ = = = = _ x _ _ _ _ _ x _ _ _ x #
        # # # # # # _ # # # # # _ # # # _ #
        # # # # # # _ # # # # # _ # # # _ #
        # x _ _ _ _ x _ x _ _ _ x _ _ _ x #
        # _ # # # # # # _ # # # # # # # _ #
        # _ # # # # # # _ # # # # # # # _ #
        # x _ _ _ _ _ _ x _ _ _ _ _ _ _ x #
        # # # # # # # # _ # # # # # # # # #
        # # # # # # # # _ # # # # # # # # #
        # x _ _ _ _ _ _ x _ _ _ _ = = = = @
        # # # # # # # # # # # # # # # # # #

}

options: {

        # # # # # # # # # # # # # # # # # +
        _ . . . . . . . . . . . . . . . o #
        # # # # # * _ * # # # * . * # * . #
        + # # # # * _ * # # # * . * # * . #
        # _ _ _ _ _ _ _ _ _ _ _ . . . . . #
        # _ * # # # # * _ * # # # # # * _ #
        # _ * # # # # * _ * # # # # # * _ #
        # _ _ _ _ _ _ _ _ _ _ _ _ _ _ _ _ #
        + # # # # # # * _ * # # # # # # # +
        + # # # # # # * _ * # # # # # # # #
        # o . . . . . . . . . . . . . . . _
        + # # # # # # # # # # # # # # # # #

}

directions: {

        v v v v v v v v v v v v v v v v v v
        > - _ _ _ _ _ _ _ _ _ _ _ _ _ _ _ <
        ^ ^ ^ ^ ^ v _ > ^ ^ ^ v _ > ^ v _ <
        > v v v v < _ ^ v v v < _ ^ v < _ <
        > _ _ _ _ _ _ _ _ _ _ _ _ _ _ _ _ <
        > _ > ^ ^ ^ ^ v _ > ^ ^ ^ ^ ^ v _ <
        > _ ^ v v v v < _ ^ v v v v v < _ <
        > _ _ _ _ _ _ _ _ _ _ _ _ _ _ _ _ <
        ^ ^ ^ ^ ^ ^ ^ v _ > ^ ^ ^ ^ ^ ^ ^ <
        > v v v v v v < _ ^ v v v v v v v v
        > _ _ _ _ _ _ _ _ _ _ _ _ _ _ _ _ <
        ^ ^ ^ ^ ^ ^ ^ ^ ^ ^ ^ ^ ^ ^ ^ ^ ^ ^

}

blueprint: {

        # # # # # # # # # # # # # # # # # #
        _ _ _ _ _ _ _ _ _ _ _ _ _ _ _ _ _ #
        # # # # # # _ # # # # # _ # # # _ #
        # # # # # # _ # # # # # _ # # # _ #
        # _ _ _ _ _ _ _ _ _ _ _ _ _ _ _ _ #
        # _ # # # # # # _ # # # # # # # _ #
        # _ # # # # # # _ # # # # # # # _ #
        # _ _ _ _ _ _ _ _ _ _ _ _ _ _ _ _ #
        # # # # # # # # _ # # # # # # # # #
        # # # # # # # # _ # # # # # # # # #
        # _ _ _ _ _ _ _ _ _ _ _ _ _ _ _ _ _
        # # # # # # # # # # # # # # # # # #

}