size: 12 19

spawns: {
    pacman: 5 6
    ghost:  8 15
}

portals: {
    2 2 11 19
}

typemap: {

        0 # # # # # # # # # # # # # # # # # #
        0 @ = = = = _ x _ _ _ _ _ x _ _ _ x #
        0 # # # # # # _ # # # # # _ # # # _ #
        0 # # # # # # _ # # # # # _ # # # _ #
        0 # x _ _ _ _ x _ x _ _ _ x _ _ _ x #
        0 # _ # # # # # # _ # # # # # # # _ #
        0 # _ # # # # # # _ # # # # # # # _ #
        0 # x _ _ _ _ _ _ x _ _ _ _ _ _ _ x #
        0 # # # # # # # # _ # # # # # # # # #
        0 # # # # # # # # _ # # # # # # # # #
        0 # x _ _ _ _ _ _ x _ _ _ _ = = = = @
        0 # # # # # # # # # # # # # # # # # #

}

options: {

        0 # # # # # # # # # # # # # # # # # +
        0 _ . . . . . . . . . . . . . . . o #
        0 # # # # # * _ * # # # * . * # * . #
        0 + # # # # * _ * # # # * . * # * . #
        0 # _ _ _ _ _ _ _ _ _ _ _ . . . . . #
        0 # _ * # # # # * _ * # # # # # * _ #
        0 # _ * # # # # * _ * # # # # # * _ #
        0 # _ _ _ _ _ _ _ _ _ _ _ _ _ _ _ _ #
        0 + # # # # # # * _ * # # # # # # # +
        0 + # # # # # # * _ * # # # # # # # #
        0 # o . . . . . . . . . . . . . . . _
        0 + # # # # # # # # # # # # # # # # #

}

directions: {

        0 v v v v v v v v v v v v v v v v v ^
        0 > - _ _ _ _ _ _ _ _ _ _ _ _ _ _ _ <
        0 ^ ^ ^ ^ ^ ^ _ > ^ ^ ^ ^ _ > ^ ^ _ <
        0 > v v v v v _ < v v v v _ < v v _ <
        0 > _ _ _ _ _ _ _ _ _ _ _ _ _ _ _ _ <
        0 > _ > ^ ^ ^ ^ ^ _ > ^ ^ ^ ^ ^ ^ _ <
        0 > _ < v v v v v _ < v v v v v v _ <
        0 > _ _ _ _ _ _ _ _ _ _ _ _ _ _ _ _ <
        0 < ^ ^ ^ ^ ^ ^ ^ _ > ^ ^ ^ ^ ^ ^ ^ v
        0 > v v v v v v v _ < v v v v v v v v
        0 > _ _ _ _ _ _ _ _ _ _ _ _ _ _ _ _ <
        0 < ^ ^ ^ ^ ^ ^ ^ ^ ^ ^ ^ ^ ^ ^ ^ ^ ^

}

blueprint: {

        0 # # # # # # # # # # # # # # # # # #
        0 _ _ _ _ _ _ _ _ _ _ _ _ _ _ _ _ _ #
        0 # # # # # # _ # # # # # _ # # # _ #
        0 # # # # # # _ # # # # # _ # # # _ #
        0 # _ _ _ _ _ _ _ _ _ _ _ _ _ _ _ _ #
        0 # _ # # # # # # _ # # # # # # # _ #
        0 # _ # # # # # # _ # # # # # # # _ #
        0 # _ _ _ _ _ _ _ _ _ _ _ _ _ _ _ _ #
        0 # # # # # # # # _ # # # # # # # # #
        0 # # # # # # # # _ # # # # # # # # #
        0 # _ _ _ _ _ _ _ _ _ _ _ _ _ _ _ _ _
        0 # # # # # # # # # # # # # # # # # #

}